5 10
|--------|
|.$.|..-.|
|..-|.@..|
|.$....-.|
|--------|