5 10
|--------|
|.$.|..-.|
|..-|.@P.|
|.$....-.|
|--------|